WWWWWWWWWWWWWWWWWWWWWWWWWWWWWWWWWWWWWWWWWWWWWWWWWWWWWWWWWWWW
WWWWWWWWWWWWWWWWWWWWWWWWWWWWWWWWWWWWWWWWWWWWWWWWWWWWWWWWWWWW
WWWE WWWWWW     WWWWWW     WWWWWW   WWWWWW  BB   WWWWWWB WWW
WWW    WW        KWW         WW         WW        EWWED  WWW
WWWWW      WWBWW      WW WW      WW WW      WW WW     DWWWWW
WWW  WW  WW DDD WW  WW     WW  WW     WW  WW     WW  WW  WWW
WWW    WW    W  E WW    W    WW    W    WW    W   EWW    WWW
WWW  WW  WW     WW  WW     WW  WW     WW  WW     WW  WW  WWW
WWWWW      WW WW      WW WWDD   BWW WW      WW WW      WWWWW
WWW               WW         WW         WW               WWW
WWWWW      WW WW      WW WW      WWEWW      WW WW      WWWWW
WWW  WW  WWB    WW  WW     WW  WW     WW  WW     WW  WW EWWW
WWW    WW  DDW    WW    W    WW    W    WW    W    WW    WWW
WWW  WW  WW     WW  WW     WW  WW     WW  WW  B  WW  WW  WWW
WWWWW      WW WW      WW WW  DD  WW WW      WW WW      WWWWW
WWW               WW         WW    D    WW               WWW
WWWWW      WW WW      WW WW      WW WW      WW WW      WWWWW
WWW  WW  WW    BWW  WW     WW  WW     WW  WW     WW  WW  WWW
WWW    WW    WDD  WW    W    WW    W    WW  DDW    WWE   WWW
WWW  WW  WW     WW  WW     WWB WW     WW  WW     WW  WW  WWW
WWWWW    DDWW WW      WW WW  DD  WWEWW      WW WW      WWWWW
WWW    WW         WW         WW         WW         WW    WWW
WW J WWWWWW     WWWWWW     WWWWWW     WWWWWW     WWWWWW  WWW
WWE      KKKKK      D                     D                WWW
WWWWWWWWWWWWWWWWWWWWWWWWWWWWWWWWWWwWWWWWWWWWWWWwWWWWWWWWWWWW