DDDDDDDDDDDDDDDDDDDDDDDDDDDDDDDDDDDDDDDDDDDDDDDDDDDDDDDDWWWW
WWEEWWWWWWDDDDDDDDDDDDDDDDDDDDDDDWWWWWWWWWWWWWWWWWWWWWWWWWWW
DDDDDDDDDDDDDDDDDDDDDDDDDDDDDDDDDDDDDDDDDDDDDDDDDDDDDDDDWWWW
DDDDDDDDDDDDDDDDDDDDDDDDDDDDDDDDDDDDDDDDDDDDDDDDDDDDDDDDWWWW
WWWWW      BBBBBBBBBBBBBBBBBBBBBBBBBBBBBBBBBBBBBBBBBBBBBBBBB
WWW  WW  WW DDD WW  WW     WW  WW     WW  WW     WW  WW  WWW
DDDDDDDDDDDDDDDDDDDDDDDDDDDDDDDDDDDDDDDDDDDDDDDDDDDDDDDDWWWW
DDDDDDDDDDDDDDDDDDDDDDDDDDDDDDDDDDDDDDDDDDDDDDDDDDDDDDDDWWWW
DDDDDDDDDDDDDDDDDDDDDDDDDDDDDDDDDDDDDDDDDDDDDDDDDDDDDDDDWWWW
WWW               WW         WW         WW               WWW
DDDDDDDDDDDDDDDDDDDDDDDDDDDDDDDDDDDDDDDDDDDDDDDDDDDDDDDDWWWW
WWW  WW  WWB    WW  WW     WW  WW     WW  WW     WW  WW DWWW
WWW    WW  DDW    WW    W    WW    W    WW    W    WW    WWW
DDDDDDDDDDDDDDDDDDDDDDDDDDDDDDDDDDDDDDDDDDDDDDDDDDDDDDDDWWWW
WWWWW      WW WW      WW WW  DD  WW WW      WW WW      WWWWW
DDDDDDDDDDDDDDDDDDDDDDDDDDDDDDDDDDDDDDDDDDDDDDDDDDDDDDDDWWWW
WWWWW      WW WW      WW WW      WW WW      WW WW      WWWWW
WWW  WW  WW    BWW  WW     WW  WW     WW  WW     WW  WW  WWW
WWW    WW    WDD  WW    W    WW    W    WW  DDW    WWDDDDDWW
WWW  WW  WW     WW  WW     WWB WW     WW  WW     WW  WW  WWW
WWDDD    DDWW WW      WW WW  DD  WWBWWD   D WW WW      WWWWW
WWW    WW         WW         WW         WW         WW    WWW
WWW  WWWWWW     WWWWWW     WWWWWW     WWWWWW     WWWWWW  WWW
WWW  WWWWWWWWWWWWWD             J              KKKKK  B  WWW
WWWWWWWWWWWWWWWWWWWWWWWWWWWWWWWWWWwWWWWWWWWWWWWwWWWWWWWWWWWW