DW W W  WDWW W DW W W WDWWW DDWD DW WWDW DDD  DWWWWW DWD WWD
 WWDD WE WW D  DD W   W DWWWDWD  WWDDDDDWDD DWW D DW WDWD W 
 W WDDW  WWWDD W WWWJDWD D DDDDDWW WWWW  D    WDDWDDWDDD   W
DWWDDDWWDWDD D W   W  WD W EDW  WWWWWW   DEDDW  DD D  D  DD 
D  WWWD WD    DDD  DWW D WWD WW  WDWWD  WWW W D WW     D  D 
 WDDWD WD D D WW   D DW  DWDWDDD W D  W W DDWW  WW DDW  DD  
  D W WDDD WD   D    WWWDW D WDWD W WDWWW  WWDDWWDD W D WDD 
D WD   DW DWDWW  DWWDDDWW DDDDDWWW  WWWWW DW EDDDK DWDW DD D
 WDWD DDWDW DWDWD W  WWDWDWD DDWWDWD  WW WW W  DDWWDDW DDD W
  WDW W DD DWW WDWD W DW  DW W   W DDDW  D DDDDW DWWDDD DW D
DW WWDW DDW  WW W D D   WWDDWDW  KDDDD  D  DW D DWDDDW DWW W
   WDDWD  WWW DW WDDW  W W   WDD  WW  W WDDDWWDD  W WWD   WD
 DDWW  DW   W W W D DDDD WW WW DD WDWD W DWDWWWDDWWDD D   DD
DW WWDWDDWDDW   WW W W  WWDDDD  D D WDWDW WWD D WD DWD WWW  
  W DD   DD DWDDWD    DD DDDDWDW WW DDD D  WWKWW W W   DD DW
W   W   WWWWDWWWD   DDWWWW WDDW  DDWWD  D  WW WWD DD DD DDD 
 DWWW DDD D DDD W DWWW DDDWDDW DD KWDWDWWWDWD WDDD D DD  DDD
D WDDD WWW WDDD  D DWDWDD  WD  W WDDWDWDWWWW D DWDDD  D WW  
WWW WW W D   DWWD W W   WWD DD WD WDDW DWDWWW DD   W W WWDW 
  W  WDW   WWWWWDDDEWW WW D DDWD WDD DWDWD DDDD D W WWWDW  W
WW WD  WWWWD  W   W  DW D DW D  DDW  DW D WWWW  W  W D  DW W
DD WWD WWDWDWWW WWD DD WDW WW W WD DD W DD   DWWWD  WDWD D D
DD  WWD  DDW   DDD WDDD  WW DWDDWWWDWW  DW W DDDWDWDW  DWDKD
DDDDD  D  DD W DWWD  DWDDDDDD DW W  D  DW WW DWWW  D DDWWDDW
  WWWDD WDW DWWWWWWD DWD WWDDW  DW DWDWWW  WDW   DWDDDD WDW 