WWWWWWWWWWWWWWWWWWWWWWWWWWWWWWWWWWWWWWWWWWWWWWWWWWWWWWWWWWWW
WWEEWWWWWWDDDDDDDDDDDDDDDDDDDDDDDWWWWWWWWWWWWWWWWWWWWWWWWWWW
WWWD WWWWWW     WWWWWW     WWWWWW   WWWWWW  BB   WWWWWWB WWW
WWW    WW        BWW         WW         WW        KWWED  WWW
WWWWW      BBBBBBBBBBBBBBBBBBBBBBBBBBBBBBBBBBBBBBBBBBBBBBBBB
WWW  WW  WW DDD WW  WW     WW  WW     WW  WW     WW  WW  WWW
WWW    WW    W  W WW    W    WW    W    WW    W    WW    WWW
WWW  WW  WW     WW  WW     WW  WW     WW  WW     WW  WW  WWW
WWWWW      WW WW      WW WWDD   BWW WW      WW WW      WWWWW
WWW               WW         WW         WW               WWW
WWWWW      WW WW      WW WW      WWEWW      WW WW      WWWWW
WWW  WW  WWB    WW  WW     WW  WW     WW  WW     WW  WW WWWW
EEEEEEEEEEEEEEEEEEEEEEEEEEEEEEEEEEEEEEEEEE    W    WW    WWW
WWW  WW  WW     WW  WW     WW  WW     WW  WW  B  WW  WW  WWW
WWWWW      WW WW      WW WW  DD  WW WW      WW WW      WWWWW
WWW               WW         WW    D    WW               WWW
WWWWW      WW WW      WW WW      WW WW      WW WW      WWWWW
WWW  WW  WW    BWW  WW     WW  WW     WW  WW     WW  WW  WWW
WWW    WW    WDD  WW    W    WW    W    WW  DDW    WWDDDDDWW
WWW  WW  WW     WW  WW     WWB WW     WW  WW     WW  WW  WWW
WWDDD    DDWW WW      WW WW  DD  WWBWWD   D WW WW      WWWWW
WWW    WW         WW         WW         WW         WW    WWW
WWW  WWWWWW     WWWWWW     WWWWWW     WW         EEEEDD  EEE
WWW  WWWWWWWWWWWWWD                     DKKKKK        J  WWW
WWWWWWWWWWWWWWWWWWWWWWWWWWWWWWWWWWwWWWWWWWWWWWWwWWWWWWWWWWWW